tRNA	Codon
TMtRNA-Ala-1	GCC
TMtRNA-Ala-2	GCA
TMtRNA-Ala-3	GCG
TMtRNA-Arg-1	CGG
TMtRNA-Arg-2	AGG
TMtRNA-Arg-3	CGA
TMtRNA-Arg-4	AGA
TMtRNA-Arg-5	CGC
TMtRNA-Asn-1	AAC
TMtRNA-Asp-1	GAC
TMtRNA-Cys-1	TGC
TMtRNA-Gln-1	CAG
TMtRNA-Gln-2	CAA
TMtRNA-Glu-1	GAG
TMtRNA-Glu-2	GAA
TMtRNA-Gly-1	GGG
TMtRNA-Gly-2	GGA
TMtRNA-Gly-3	GGC
TMtRNA-His-1	CAC
TMtRNA-Ile-1	ATC
TMtRNA-Leu-1	TTA
TMtRNA-Leu-2	CTC
TMtRNA-Leu-3	CTA
TMtRNA-Leu-4	CTG
TMtRNA-Leu-5	TTG
TMtRNA-Lys-1	AAG
TMtRNA-Lys-2	AAA
TMtRNA-Met-1	ATG
TMtRNA-Met-2	ATG
TMtRNA-Met-3	ATG
TMtRNA-Phe-1	TTC
TMtRNA-Pro-1	CCG
TMtRNA-Pro-2	CCA
TMtRNA-Pro-3	CCC
TMtRNA-Ser-1	TCC
TMtRNA-Ser-2	AGC
TMtRNA-Ser-3	TCA
TMtRNA-Ser-4	TCG
TMtRNA-Thr-1	ACC
TMtRNA-Thr-2	ACA
TMtRNA-Thr-3	ACG
TMtRNA-Trp-1	TGG
TMtRNA-Tyr-1	TAC
TMtRNA-Val-1	GTC
TMtRNA-Val-2	GTG
TMtRNA-Val-3	GTA